HBC000000000000x
B000000000000000
C0z0000000000z00
0000000000000000
000000x00x000000
000000x00x000000
0000000000000000
00z0000000000z0c
000000000000000b
x000000000000cbh